#####################
#*.................*#
#.##.#.#######.#.##.#
#....#.........#....#
####.#.###%###.#.####
#......#  $  #......#
####.#.#######.#.####
#  #.#....@....#.#  #
####.#.#######.#.####
#.........#.........#
#.##.####.#.####.##.#
#*.#.............#.*#
##.#.#.#######.#.#.##
#...................#
#####################
